1111111111
1C00000001
1111111111